75,75,75,75,75,75,76,0,0,31,31,31,31,31,31,31
75,75,75,75,75,75,76,0,0,31,31,31,31,31,31,31
75,75,75,75,75,75,76,0,0,0,0,0,0,0,0,0
75,75,75,75,75,75,76,0,0,0,0,0,0,0,0,0
85,85,85,85,85,85,86,0,0,0,31,0,31,31,0,0
0,0,0,0,0,0,0,0,0,0,0,0,0,0,0,0
22,22,22,0,0,0,0,0,0,0,31,0,31,31,0,0
21,21,21,0,0,0,0,0,0,0,0,0,0,0,0,0
21,21,21,0,0,0,0,0,0,0,0,0,0,0,0,0
21,21,21,31,31,31,31,31,31,31,31,31,31,31,31,31
21,21,21,31,31,31,31,31,31,31,31,31,31,31,31,31
