75,75,75,75,75,75,75,75,75,75,75,75,75,75,75,75
75,75,75,75,75,75,75,75,75,75,75,75,75,75,75,75
75,75,75,75,75,75,75,75,75,75,75,75,75,75,75,75
75,75,75,75,75,75,75,75,75,75,75,75,75,75,75,75
85,85,85,85,85,85,85,85,85,85,85,85,85,85,85,85
0,0,0,0,0,0,0,0,0,0,0,0,0,0,0,0
0,0,0,0,0,0,0,0,0,0,0,0,0,0,0,0
31,31,31,31,31,31,31,31,31,31,31,31,31,31,31,31
31,31,31,31,31,31,31,31,31,31,31,31,31,31,31,31
31,31,31,31,31,31,31,31,31,31,31,31,31,31,31,31
31,31,31,31,31,31,31,31,31,31,31,31,31,31,31,31
