75,1,1,1,1,1,1,1,1,1,1,1,1,1,1,75
75,1,1,1,1,1,1,1,1,1,1,1,1,1,1,75
75,1,0,0,0,0,0,0,0,0,0,0,0,0,1,75
75,1,0,8,9,0,8,73,9,0,8,9,0,0,1,75
75,1,0,18,19,0,18,61,19,0,18,19,0,0,1,75
75,1,0,0,0,0,0,0,0,0,0,0,0,0,0,72
75,1,0,0,8,9,0,0,0,8,9,0,0,0,2,75
75,1,0,0,18,19,0,0,0,18,19,0,0,0,1,75
75,1,0,0,0,0,0,0,0,0,0,0,0,0,1,75
75,1,2,2,2,2,2,2,2,2,2,2,2,2,1,75
75,1,1,1,1,1,1,1,1,1,1,1,1,1,1,75
