21,21,21,21,21,21,21,21,21,21,21,21,21,21,21,21
21,21,21,21,21,21,21,61,21,21,21,21,21,21,21,21
21,0,0,0,0,0,0,0,0,0,0,0,0,0,34,21
21,0,0,12,12,12,12,0,0,0,0,0,0,0,0,34
21,0,0,0,0,0,0,0,12,12,12,0,0,0,0,0
21,0,0,12,12,12,12,0,0,0,0,0,0,0,0,0
21,0,0,0,0,0,0,0,12,12,12,0,0,0,0,0
21,0,0,12,12,12,12,0,0,0,0,0,0,0,0,24
21,0,0,0,0,0,0,0,0,0,0,0,0,0,24,21
21,22,22,22,22,22,22,22,22,22,22,23,0,0,21,21
21,21,21,21,21,21,21,21,21,21,21,21,0,0,21,21
