21,21,21,21,21,21,21,21,21,21,21,21,0,0,21,21
21,21,21,21,21,21,21,21,21,21,21,33,0,0,21,21
21,0,0,0,0,0,0,0,0,0,0,0,0,0,21,21
21,0,0,0,0,0,0,0,32,0,0,0,0,0,34,21
21,0,0,0,0,0,0,0,0,0,32,0,0,0,0,34
21,0,32,0,0,32,0,0,32,0,0,0,0,0,0,0
21,0,0,0,0,0,0,0,0,0,32,0,0,0,0,24
21,0,0,0,0,0,0,0,32,0,0,0,0,0,24,21
21,0,0,0,0,0,0,0,0,0,0,0,0,0,21,21
21,22,22,22,22,22,22,22,22,22,22,22,22,22,21,21
21,21,21,21,21,21,21,21,21,21,21,21,21,21,21,21
