75,75,75,75,75,75,76,0,0,31,31,31,31,31,31,31
75,75,75,75,75,75,76,0,0,31,31,31,31,31,31,31
75,75,75,75,75,75,76,0,0,0,0,0,0,31,31,31
75,75,75,75,75,75,76,0,0,0,0,0,0,31,31,31
85,85,85,85,85,85,86,0,0,0,0,0,0,31,31,31
0,0,0,0,0,0,0,0,0,0,0,0,0,31,31,31
0,0,0,0,0,0,0,0,0,0,0,0,0,31,31,31
31,31,31,0,0,0,0,0,0,0,0,0,0,31,31,31
31,31,31,0,0,0,0,0,0,0,0,0,0,31,31,31
31,31,31,31,31,31,31,31,31,31,31,31,31,31,31,31
31,31,31,31,31,31,31,31,31,31,31,31,31,31,31,31
