75,75,75,75,75,75,76,0,0,11,11,11,11,11,11,11
75,75,75,75,75,75,76,0,0,11,11,11,11,11,11,11
75,75,75,75,75,75,76,0,0,0,11,0,0,0,0,11
75,75,75,75,75,75,76,0,0,0,0,0,0,0,0,11
75,75,75,75,75,75,76,0,0,0,0,0,11,0,0,11
72,72,72,72,72,72,72,0,0,0,0,0,0,0,0,11
75,75,75,75,75,75,76,0,0,0,0,0,11,0,0,11
75,75,75,75,75,75,76,0,0,0,0,0,0,0,0,11
75,75,75,75,75,75,76,0,0,0,11,0,0,0,0,11
75,75,75,75,75,75,76,0,0,11,11,11,11,11,11,11
75,75,75,75,75,75,76,0,0,11,11,11,11,11,11,11
