21,21,21,21,21,21,21,21,21,21,21,21,21,21,21,21
21,21,21,21,21,21,21,21,21,21,21,21,21,21,21,21
21,33,0,0,0,0,0,0,0,34,33,0,0,0,34,21
33,0,0,32,0,32,0,0,0,0,0,0,32,0,0,34
0,0,0,0,0,0,0,0,0,0,0,0,0,0,0,0
0,0,0,32,0,32,0,0,0,0,0,0,32,0,0,0
0,0,0,0,0,0,0,0,0,0,0,0,0,0,0,0
23,0,0,32,0,32,0,0,0,0,0,0,32,0,0,24
21,23,0,0,0,0,0,0,0,24,23,0,0,0,24,21
21,21,22,22,22,22,22,0,0,21,21,22,22,22,21,21
21,21,21,21,21,21,21,0,0,21,21,21,21,21,21,21
