21,21,21,21,21,21,21,0,0,21,21,21,21,21,21,21
21,21,21,21,61,21,33,0,0,21,21,21,21,21,21,21
21,21,21,33,0,0,0,0,0,21,21,21,21,21,21,21
21,21,33,0,0,0,0,0,0,21,21,21,21,21,21,21
21,33,0,0,0,0,0,0,0,34,21,21,21,21,21,21
0,0,0,0,0,0,0,0,0,0,0,0,0,0,0,0
22,23,0,0,0,0,0,0,0,0,0,0,0,0,22,22
21,21,0,0,0,0,0,0,0,0,0,0,0,0,21,21
21,21,0,0,0,0,0,0,0,0,0,0,0,0,21,21
21,21,22,22,22,22,22,22,22,22,22,22,22,22,21,21
21,21,21,21,21,21,21,21,21,21,21,21,21,21,21,21
