31,31,31,31,31,31,31,31,31,31,31,31,31,31,31,31
31,31,31,31,31,31,31,31,31,31,31,31,31,31,31,31
0,0,0,0,0,0,0,0,0,0,0,0,0,0,0,31
31,0,31,0,0,0,31,0,0,31,0,31,0,0,0,31
0,0,0,0,0,0,0,0,0,0,0,0,0,0,0,0
31,0,31,0,31,0,31,0,0,31,0,31,0,31,0,0
0,0,0,0,0,0,0,0,0,0,0,0,0,0,0,0
31,0,31,0,0,0,31,0,0,31,0,31,0,0,0,31
0,0,0,0,0,0,0,0,0,0,0,0,0,0,0,31
31,31,31,0,31,0,31,0,0,31,0,31,0,31,0,31
31,31,31,0,31,0,31,0,0,31,0,31,0,31,0,31
