21,21,31,0,31,0,31,0,0,31,0,31,0,31,0,31
21,21,31,0,31,0,31,0,0,31,0,31,0,31,0,31
21,33,0,0,0,0,0,0,0,0,0,0,0,0,0,31
33,0,0,0,31,0,0,0,0,31,0,0,0,31,0,31
0,0,31,0,0,0,0,0,0,0,0,0,0,0,0,0
0,0,0,0,31,0,31,0,0,31,0,31,0,31,0,0
0,0,31,0,0,0,0,0,0,0,0,0,0,0,0,0
22,0,0,0,31,0,0,0,0,31,0,0,0,31,0,31
21,22,0,0,0,0,0,0,0,0,0,0,0,0,0,31
21,21,31,0,31,0,31,0,0,31,0,31,0,31,0,31
21,21,31,0,31,0,31,0,0,31,0,31,0,31,0,31
